28 102
000000000000000000000000000000000000000000000000000000000011111111111111111111111111111111111111111111
000000000000000000000000000000000000000000000000000000000011111111111111111111111111111111111111111111
000000000000000000000000000000000000000000000000000000000011111111000000000000000000000000000000000011
000000000000000000000000000000000000000000000000000000000111111110000000000000000000000000000000000011
000000000000000000000000000000000000000000000000000000001111111110000000000000000000000000000000000011
000000000000000000000000000000000000000000000000000000011111111000000000000000000000000000000000000011
000000000000000000000000000000000000000000000000000000111111110000000000011000000000C00E00000110000011
000000000000000000000000000000000000000000000000000000111000000000000000111111111111111111111111000011
000000000000000000000000000000000000000000000000000001110000000000000011111111111111111111111111100011
000000000000000000000000000000000000000000000000000001110000000000000011111111111111111111111111100011
000000000000000000000000000000000000000000000000000001110000000000000001111111111111111111111111100011
000000000000000000000000000000000000000000000000000111110C00000E01100000011111111111111111111111100011
000000000000000000000000000000000000000000000000000111111111111111100000011111111111111111111111100011
000000000000000000000000000000000000000000000000000111111111111111110000011111111111111111111111100011
000000000000000000000000000000000000000000000000000111111111111111110000011111111111111111111111100011
000000000000000000000000000000000000000000000000000000000000000000100000011111111111111111111111000011
000000000000000000000000000000000000000000000000000000000000000000000001111111110000000000000000000011
000000000000000000000000000000000000000000000000000000000000000000000001111111100000000000000000000011
000000000000000000000000000000000000000000000000000000000000000000000011111111100000000000000000000011
000000000000000000000000000000000000000000011000000E0000C00000000111111111111110000001100000E000000011
000000000000000000000000000000000000000001111111111111111111111111111111111111100000011111111111111111
000000000000000000000000000000000000000011111111111111111111111111111111111111100000001111111111111111
00111000000000S000000000000000000E00000111111111111111111111111111111111111111111000000000000000000W00
111111111111111111111111111111111111111111111111111111111111111111111111111111111110000000000000000W00
111111111111111111111111111111111111111111111111111111111111111111111111111111111111000000000000000W00
111111111111111111111111111111111111111111111111111111111111111111111111111111111111111111111111111111
111111111111111111111111111111111111111111111111111111111111111111111111111111111111111111111111111111
111111111111111111111111111111111111111111111111111111111111111111111111111111111111111111111111111111