24 103
1100000000000000000000000000000000000000000000000000000000000000000000000000000000000000000000000000W00
1110000000000000000000000000000000000000000000000000000000000000000000000000000000000000000000000000W00
1111000000000000000000000000000000000000000000000000000000000000000000000000000000000000000000000000W00
1111100000000000000000000000000000000000000000000000000000000000000000000000000000000000000000000000W00
1111100000000000000000000000000000000000000000000000000000000000000000000000000000000000000000000000W00
1111110000000000000000000000000000000000000000000000000000000000000000000000000000000000000000000000W00
111111100000000000000000000000000000000000000000000000110000000000000000000000E000000000000000000000W00
1111111110000000000000000000000000000000000000000000001111111111111111111111111111111111111111111111111
1111111111000000000000000000000000000000000000000000011111111111111111111111111111111111111111111111111
1111111111000000000000000000000000000000000000000000011111111111111111111111111111111111111111111111111
1111111111100000000000000000000000000000000000000000011111111111111111111111111111111111111111111111111
1111111111100000000000000000000000000000000000000000111111111111111111111111111111111111111111111111111
1111111111110000000000000000000000000000000000000001111111111111111111111111111111111111111111111111111
1111111111110000000000000000000000000000000000000001111111111111111111111111111111111111111111111111111
1111111111110000000000000000000000000000000000000001111111111111111111111111111111111111111111111111111
1111111111100000000000000000000000000000000000001111111111111111111111111111111111111111111111111111111
1111111111000000000000000000000000000000000000011111111111111111111111111111111111111111111111111111111
L000000000000000000000000000000000000000000000011111111111111111111111111111111111111111111111111111111
L000000000000000000000000000000000000000000000011111111111111111111111111111111111111111111111111111111
L000000000000110000000000000000000000000000001111111111111111111111111111111111111111111111111111111111
L000000000011110000000000000E00000000000000111111111111111111111111111111111111111111111111111111111111
L000001111111111111111111111111111111111111111111111111111111111111111111111111111111111111111111111111
1111111111111111111111111111111111111111111111111111111111111111111111111111111111111111111111111111111
1111111111111111111111111111111111111111111111111111111111111111111111111111111111111111111111111111111