28 30
888888888888888888888888888888
888888888888888888888888888888
888888888888888888888888888888
888888888888888888888888888888
888888888888888888888888888888
888888888888888888888888888888
888888888888888888888888888888
888888888888888888888888888888
888888888888888888888888888888
888888888888888888888888888888
888888888888888888888888888888
888888888888888888888888888888
888888888888888888888888888888
888888888888888888888888888888
888888888888888888888888888888
888888888888888888888888888888
888888888888888888888888888888
888888888888888888888888888888
T88888888888888888888888888888
T88888888888888888888888888888
T88888888888888888888888888888
T88888888888888888888888888888
T88888888888888888888888888888
T88888888888888888J88888K88888
111111111111111111111111111111
111111111111111111111111111111
111111111111111111111111111111
111111111111111111111111111111